198 2742
2 3 4 5 6 7 8 9 10 11 12 13 14 15 16 17 18 19 20 21 22 23 24 
1 18 20 21 22 72 74 43 113 78 4 30 5 6 33 34 35 37 7 62 63 114 40 41 48 49 9 10 11 13 87 89 31 91 92 93 94 96 98 99 115 104 
1 12 19 21 22 24 42 65 66 69 70 72 75 76 77 4 25 26 29 30 5 32 45 46 6 36 7 10 11 13 14 16 17 31 94 101 102 105 106 107 
1 2 3 12 19 21 22 42 74 43 113 26 30 44 5 45 46 6 37 7 38 47 114 40 41 48 49 50 51 52 53 54 55 56 57 58 10 11 13 14 16 17 31 91 93 104 
1 2 3 4 12 18 19 21 22 24 42 74 43 113 26 27 28 30 44 45 46 6 37 7 38 47 83 114 40 41 48 49 50 51 52 53 54 55 56 57 58 59 60 61 10 116 117 118 11 13 14 16 17 119 31 91 93 101 102 104 
1 2 3 4 5 12 18 19 21 22 24 42 74 43 113 26 30 44 45 46 37 7 38 47 114 40 41 48 49 50 51 52 53 54 55 56 57 58 10 116 11 13 14 16 17 31 91 93 104 
1 2 3 4 5 6 12 19 21 22 42 74 43 113 26 30 44 45 46 37 38 47 114 40 41 48 49 50 51 52 53 54 55 56 57 58 59 60 61 10 11 13 14 16 17 31 91 93 104 
1 18 19 23 24 64 73 74 113 9 10 14 16 17 87 94 95 115 109 103 104 110 108 
1 2 8 18 19 20 21 23 24 33 34 35 36 37 38 10 14 15 16 17 
1 2 3 4 5 6 7 8 9 18 19 22 23 24 42 65 70 74 43 113 75 76 77 26 30 44 45 46 37 38 47 114 40 41 48 49 50 51 52 53 54 55 56 57 58 11 13 14 16 17 31 91 93 94 101 102 104 105 106 107 
1 2 3 4 5 6 7 10 12 19 21 22 64 42 72 74 43 113 26 30 44 45 120 46 81 37 38 47 62 83 63 114 40 41 48 49 50 51 52 53 54 55 56 57 58 13 14 16 17 89 31 91 92 93 99 104 
1 3 4 5 6 7 11 25 26 27 28 29 30 13 14 16 17 19 21 31 22 
1 2 3 4 5 6 7 10 11 12 18 19 21 22 64 42 65 69 70 72 74 43 113 75 76 77 25 26 27 28 29 30 44 45 46 81 37 38 47 62 83 63 114 40 41 48 49 50 51 52 53 54 55 56 57 58 59 60 61 14 16 17 89 31 91 92 93 94 99 101 102 104 105 106 107 
1 3 4 5 6 7 8 9 10 11 12 13 18 19 21 22 23 24 42 43 26 44 45 46 37 38 47 48 49 50 51 52 53 54 55 56 57 58 59 60 61 16 17 
1 9 20 21 78 45 121 122 115 104 
1 3 4 5 6 7 8 9 10 11 12 13 14 18 19 21 22 23 24 42 65 70 72 43 75 76 77 78 26 27 28 29 123 79 44 32 124 125 45 111 46 36 37 38 47 62 39 48 49 50 51 52 53 54 55 56 57 58 59 60 61 17 86 126 31 91 94 101 102 109 104 105 106 107 
1 3 4 5 6 7 8 9 10 11 12 13 14 16 18 19 21 22 23 24 42 65 66 69 70 72 75 76 77 25 26 29 30 45 52 59 60 61 31 94 101 102 105 106 107 
1 2 5 6 8 9 10 13 14 16 17 30 32 33 34 35 36 37 38 39 40 41 19 20 21 31 22 23 24 
1 3 4 5 6 7 8 9 10 11 12 13 14 16 17 18 42 43 26 44 45 46 37 38 47 48 49 50 51 52 53 54 55 56 57 58 59 60 61 21 22 23 24 
1 2 9 15 18 62 63 41 48 49 21 31 
1 2 3 4 5 6 7 9 11 12 13 14 15 16 17 18 19 20 62 63 48 49 22 
1 2 3 4 5 6 7 10 11 12 13 14 16 17 18 19 21 64 42 65 66 67 68 69 70 71 72 73 74 75 76 77 78 25 26 27 28 29 30 79 44 32 45 46 80 81 82 36 37 38 47 62 83 63 39 48 49 50 51 52 53 54 55 56 57 58 59 60 61 84 85 86 87 88 89 90 31 91 92 93 94 95 96 97 98 99 100 101 24 102 103 104 105 106 107 108 
1 8 9 10 14 16 17 18 19 64 73 74 87 94 95 24 109 103 110 108 
1 3 5 6 8 9 10 14 16 17 18 19 22 23 72 30 32 111 46 34 36 39 40 41 112 31 
3 12 13 17 22 90 31 133 92 104 66 69 72 27 28 29 30 
3 4 5 6 7 10 11 12 13 14 16 17 19 22 119 31 101 102 42 43 30 44 45 120 46 37 38 47 62 83 41 48 49 50 51 52 53 54 55 56 57 58 118 
5 12 13 16 22 25 126 178 31 91 97 101 102 109 104 105 106 107 42 65 67 70 43 131 75 76 77 28 29 30 123 124 125 111 63 40 116 117 118 122 190 
5 12 13 16 22 25 27 126 90 31 92 97 101 102 109 104 105 106 107 42 65 70 72 131 75 76 77 29 30 123 124 125 111 63 40 116 117 118 190 
3 12 13 16 17 22 25 27 28 87 90 178 130 31 133 92 97 101 102 104 64 65 66 69 72 73 74 128 77 30 118 
2 3 4 5 6 7 10 11 12 13 17 18 22 24 25 26 27 28 29 86 150 154 119 177 155 178 159 31 162 133 91 93 96 97 115 101 102 104 66 69 72 74 43 113 76 37 83 114 40 41 116 118 
2 3 4 5 6 7 10 11 12 13 16 17 18 20 22 24 25 26 27 28 29 30 87 136 137 132 168 171 150 88 153 154 90 119 177 155 178 156 157 130 179 159 160 64 42 65 66 67 68 69 70 71 72 73 74 43 131 113 128 75 76 77 111 186 81 37 189 83 63 164 39 114 40 41 56 57 183 184 116 117 118 112 122 190 161 162 133 163 181 91 92 93 94 97 115 101 102 104 105 106 
3 16 18 22 24 176 187 123 79 44 185 45 120 186 46 36 39 145 146 
2 9 18 34 35 36 37 38 
2 9 18 24 33 35 36 37 38 
2 9 18 33 34 36 37 38 
3 9 16 18 22 24 32 33 34 35 44 185 124 45 120 46 37 38 50 51 52 54 196 121 
2 4 5 6 7 9 10 11 13 14 16 18 19 22 26 30 31 33 34 35 36 91 93 104 42 74 43 113 44 185 45 46 38 47 114 40 41 48 49 50 51 52 53 54 55 56 57 58 
4 5 6 7 9 10 11 13 14 16 18 19 22 26 33 34 35 36 37 42 44 45 186 46 47 48 49 50 51 52 53 54 55 56 57 58 61 112 
16 18 22 24 31 32 88 102 110 72 111 
2 4 5 6 7 10 11 13 18 24 27 28 30 31 37 91 93 104 42 72 74 43 113 186 114 41 116 117 118 
2 4 5 6 7 10 11 13 18 20 24 26 30 31 37 40 91 93 104 74 43 113 63 114 57 
3 4 5 6 7 10 11 13 14 16 17 19 22 26 27 28 31 37 38 40 126 94 101 102 109 105 106 107 65 70 75 76 77 123 44 124 125 45 111 46 47 48 49 50 51 52 53 54 55 56 57 58 116 117 118 
2 4 5 6 7 10 11 13 14 16 19 26 27 30 31 37 40 41 86 87 89 91 92 93 94 96 98 99 115 102 104 107 67 72 74 113 76 78 80 82 63 114 55 56 57 58 122 190 
4 5 6 7 10 11 13 14 16 19 22 26 32 36 37 38 42 176 187 100 107 123 79 185 45 120 186 46 82 47 48 49 50 51 52 53 54 55 56 57 58 
3 4 5 6 7 10 11 13 14 15 16 17 19 22 26 32 36 37 38 42 44 176 187 115 104 78 123 79 185 124 120 186 46 47 48 49 50 51 52 53 54 55 56 57 58 196 121 59 60 61 122 
3 4 5 6 7 10 11 13 14 16 19 22 24 26 32 36 37 38 42 44 45 176 187 123 79 185 124 125 120 186 47 62 63 48 49 50 51 52 53 54 55 56 57 58 196 121 
4 5 6 7 10 11 13 14 16 19 22 26 37 38 42 44 45 46 189 48 49 50 51 52 53 54 55 56 57 58 
2 4 5 6 7 10 11 13 14 16 19 20 21 22 26 37 38 42 44 45 46 47 100 107 82 62 63 49 50 51 52 53 54 55 56 57 58 61 112 
2 4 5 6 7 10 11 13 14 16 19 20 21 22 26 37 38 42 44 45 46 47 48 100 107 186 82 62 63 50 51 52 53 54 55 56 57 58 61 112 
4 5 6 7 10 11 13 14 16 19 22 26 36 37 38 42 44 45 46 47 48 49 185 124 51 52 53 54 55 56 57 58 196 121 
4 5 6 7 10 11 13 14 16 19 22 26 36 37 38 42 44 45 46 47 48 49 50 185 124 52 53 54 55 56 57 58 196 121 
4 5 6 7 10 11 13 14 16 17 19 22 26 36 37 38 42 44 45 46 47 48 49 50 51 185 120 62 53 54 55 56 57 58 59 60 61 
4 5 6 7 10 11 13 14 16 19 22 26 37 38 42 44 45 46 47 48 49 50 51 52 186 54 55 56 57 58 61 112 
4 5 6 7 10 11 13 14 16 19 22 26 36 37 38 42 44 45 46 47 48 49 50 51 52 53 185 55 56 57 58 
4 5 6 7 10 11 13 14 16 19 22 26 37 38 42 43 44 45 46 47 48 49 50 51 52 53 54 120 62 56 57 58 
4 5 6 7 10 11 13 14 16 19 22 26 31 37 38 42 43 44 45 46 47 48 49 50 51 52 53 54 55 120 62 57 58 
4 5 6 7 10 11 13 14 16 19 22 26 31 37 38 41 42 43 44 45 46 47 48 49 50 51 52 53 54 55 56 120 62 58 
4 5 6 7 10 11 13 14 16 19 22 26 37 38 42 43 44 45 46 47 48 49 50 51 52 53 54 55 56 57 101 104 131 
5 7 13 14 16 17 19 22 45 52 62 63 60 61 
5 7 13 14 16 17 19 22 45 52 59 62 63 61 
5 7 13 14 16 17 19 22 38 45 48 49 52 53 59 60 186 112 
2 11 13 16 20 21 22 26 46 48 49 52 55 56 57 59 60 89 92 99 107 64 72 120 81 83 63 
2 11 13 20 21 22 27 28 31 41 43 46 48 49 59 60 62 89 91 92 99 101 102 105 106 64 65 67 70 72 131 75 76 77 125 81 83 122 190 
8 11 13 22 23 29 31 62 63 85 89 90 92 94 95 187 97 99 100 101 102 109 104 110 105 106 108 188 65 66 68 69 70 71 72 73 74 75 76 77 78 80 81 83 
3 10 13 16 17 22 27 28 29 31 42 63 64 86 157 130 94 97 101 102 105 106 107 68 70 71 131 75 76 77 190 
3 17 22 25 29 30 31 64 85 87 94 95 97 100 115 101 102 104 105 108 68 69 71 72 74 113 128 76 78 
22 27 31 43 63 86 88 89 90 91 92 93 94 96 98 99 100 78 80 81 82 122 190 
22 31 64 65 66 85 86 87 88 90 130 91 94 95 97 100 101 102 110 105 106 108 69 70 71 72 73 74 131 128 75 76 77 78 129 
3 13 17 22 25 29 30 31 64 66 68 85 94 95 100 101 102 104 108 71 72 76 78 
3 10 13 16 17 22 27 28 31 42 63 64 65 68 86 94 101 102 105 106 107 71 131 75 76 77 190 
22 31 64 65 66 68 69 70 85 87 94 95 100 101 102 108 72 131 128 75 76 77 78 
2 3 11 13 16 17 22 24 25 28 29 30 31 39 40 43 62 63 64 66 68 69 71 85 86 87 89 90 130 91 92 94 95 187 96 97 98 99 100 115 101 102 109 104 110 108 188 73 74 113 76 78 111 81 129 83 116 112 122 
8 22 23 29 31 64 68 72 85 86 87 89 90 130 91 92 94 95 187 96 97 101 102 109 103 110 108 188 74 76 129 
2 4 5 6 7 8 10 11 13 22 23 29 30 31 37 40 41 43 64 66 68 72 73 85 86 87 89 90 130 91 92 93 94 95 187 96 97 98 99 115 101 102 109 103 104 110 108 188 113 76 78 129 114 
3 10 13 16 17 22 27 28 31 42 63 64 65 68 70 71 86 94 101 102 105 106 107 131 76 77 190 
3 10 13 16 17 22 27 28 30 31 42 43 63 64 65 66 68 69 70 71 72 73 74 75 85 86 87 175 88 90 130 160 91 94 95 96 97 100 115 101 102 104 110 105 106 107 108 131 113 128 77 78 129 194 190 
3 10 13 16 17 22 27 28 29 31 42 63 64 65 68 70 71 75 76 86 94 101 102 105 106 107 131 190 
2 15 16 22 43 45 64 66 67 68 69 71 72 74 76 85 86 87 88 89 90 133 91 92 93 94 95 96 97 98 99 100 115 101 102 109 104 110 107 108 113 80 81 82 121 122 
16 22 32 44 45 46 176 187 107 123 185 120 186 
22 43 64 67 78 86 88 89 90 119 91 92 93 97 98 99 100 109 104 81 82 
11 13 22 31 62 63 64 67 72 78 80 86 136 137 168 150 88 153 89 90 119 156 157 130 160 161 133 181 91 92 93 98 99 100 82 83 164 
22 43 44 48 49 67 78 80 81 86 88 89 90 91 92 93 98 99 100 107 
5 11 13 22 26 30 31 62 63 64 72 81 136 137 168 150 153 89 119 156 157 130 179 160 161 133 181 92 99 101 102 164 183 184 118 84 
22 83 89 92 97 104 
22 64 66 68 69 71 72 73 74 76 78 127 128 129 86 87 130 91 94 95 100 101 102 110 108 
16 22 30 43 65 67 68 70 72 73 74 75 76 77 78 80 81 82 85 127 131 113 129 87 132 88 89 90 130 133 91 92 93 96 97 98 99 100 115 101 102 104 110 105 106 107 
2 8 22 23 29 31 43 66 68 71 72 73 74 76 78 85 86 127 113 128 129 89 130 133 91 92 94 96 97 98 99 115 101 102 109 103 104 110 108 
22 31 39 67 68 76 78 80 81 82 86 132 128 89 90 91 92 93 94 97 98 99 100 102 
2 11 13 22 43 62 63 64 67 72 73 74 78 80 81 82 83 84 86 87 88 132 113 90 133 91 92 93 94 95 187 96 97 98 99 100 115 109 104 107 108 188 
22 25 28 29 31 64 67 68 72 73 74 76 78 80 81 82 86 88 89 132 128 91 92 93 94 95 187 97 98 99 100 102 109 104 107 108 188 
2 4 5 6 7 10 11 13 16 22 27 30 31 37 40 41 43 63 67 68 72 73 74 76 78 80 81 82 85 86 87 88 89 90 132 130 133 113 129 114 122 190 92 93 94 96 97 98 99 100 115 101 102 104 110 107 
2 11 13 22 25 28 29 31 43 62 63 64 67 72 73 74 78 80 81 82 83 84 86 87 88 89 90 91 132 113 93 94 95 187 96 97 98 99 100 115 109 104 107 108 188 
2 4 5 6 7 10 11 13 22 30 31 37 40 41 43 67 74 78 80 81 82 86 88 89 90 91 92 132 113 114 94 96 98 99 100 104 
2 3 8 10 13 16 17 22 23 31 42 43 64 65 66 67 68 69 70 71 72 73 74 75 76 77 78 85 87 88 89 90 91 92 93 131 113 128 95 187 96 97 98 99 100 115 101 102 109 103 104 110 105 106 107 108 188 
8 22 23 64 66 68 69 71 72 73 74 76 78 85 89 90 92 94 187 97 100 101 102 109 110 108 188 
2 22 30 43 67 72 73 74 76 78 86 87 89 91 92 93 94 113 97 98 99 115 102 103 104 110 
22 27 28 29 30 31 64 65 66 68 72 73 74 76 78 80 84 86 87 88 89 90 91 92 94 95 96 178 157 133 187 113 128 186 118 115 101 102 109 104 108 188 
2 22 43 67 72 74 78 80 81 82 86 87 88 89 90 91 92 93 94 96 113 99 100 115 104 
2 11 13 22 43 62 63 64 67 72 74 78 80 81 82 83 86 87 88 89 90 91 92 93 94 96 98 113 100 115 104 107 
22 44 48 49 64 66 67 68 69 71 72 76 78 80 81 82 85 86 88 89 90 91 92 93 94 95 98 99 131 101 102 107 108 
3 5 10 13 16 17 22 26 27 28 29 30 31 42 58 63 64 65 66 68 69 70 71 72 73 74 75 76 77 78 83 85 86 87 91 94 95 97 100 119 156 157 130 131 129 118 190 102 110 105 106 107 108 
3 5 10 13 16 17 22 26 27 28 29 30 31 39 42 43 63 64 65 66 68 69 70 71 72 73 74 75 76 77 78 83 85 86 87 88 90 91 94 95 96 97 100 101 136 119 156 130 115 131 113 128 129 194 118 190 104 110 105 106 107 108 
8 22 23 73 74 87 94 96 109 
2 4 5 6 7 8 10 11 13 15 16 22 25 27 28 29 30 31 37 40 41 43 45 58 64 66 69 72 74 76 78 80 84 86 87 89 90 91 92 93 94 96 97 98 99 102 157 133 115 109 113 128 111 114 194 121 122 110 107 
3 10 13 16 17 22 27 28 31 42 63 64 65 66 68 70 75 76 77 86 94 101 102 131 190 106 107 
3 10 13 16 17 22 27 28 31 42 63 64 65 68 70 75 76 77 86 94 101 102 105 131 190 107 
3 10 13 16 17 22 27 28 42 43 44 48 49 62 65 70 75 76 77 78 79 82 86 89 90 91 92 94 99 100 101 102 104 105 106 126 109 123 124 125 111 
8 22 23 64 66 68 69 71 72 73 74 76 78 85 87 89 90 92 94 95 97 100 101 102 187 109 110 188 
8 16 23 27 28 42 64 72 73 74 78 80 87 89 90 92 94 95 97 103 104 107 108 126 187 123 124 125 111 188 
8 23 39 64 68 72 73 74 76 78 85 86 87 91 94 95 96 101 102 104 108 130 115 129 
16 24 27 28 31 39 42 72 104 107 109 126 123 124 125 112 
24 31 38 48 49 53 61 72 111 186 
2 4 5 6 7 8 10 11 13 30 31 37 40 41 43 66 72 74 76 78 86 87 89 91 92 93 94 96 97 98 99 102 104 149 171 133 180 115 114 
2 4 5 6 7 10 11 13 30 31 37 40 41 43 74 91 93 104 113 
2 8 15 30 31 43 45 66 72 74 76 78 86 87 89 91 92 94 96 97 98 99 102 104 110 113 133 121 122 
5 6 27 28 30 31 40 42 72 186 117 118 
5 27 28 31 40 42 116 118 
5 26 27 28 29 30 31 40 42 83 97 101 102 116 117 119 178 
5 26 30 31 80 81 83 101 102 118 136 137 132 148 149 168 169 150 172 176 152 153 164 156 157 130 160 161 133 180 181 
11 26 32 36 44 45 46 52 55 56 57 62 79 176 187 123 185 186 
15 36 45 46 50 51 78 104 115 185 124 196 122 
15 27 31 43 45 63 67 72 78 91 104 115 121 190 
16 27 28 32 42 44 45 46 79 107 109 111 120 126 176 187 185 124 125 186 
16 27 28 36 42 45 46 50 51 107 109 111 121 123 126 185 125 196 145 146 
16 27 28 42 46 63 107 109 111 123 124 126 141 
16 27 28 42 107 109 111 123 124 125 134 135 141 142 138 143 144 145 146 136 137 147 132 148 149 150 151 152 153 154 155 156 157 130 158 159 160 161 162 133 163 
85 86 87 
29 31 66 68 71 76 85 87 88 90 94 97 102 104 195 
68 72 73 74 76 85 86 87 91 101 102 110 130 
29 31 65 68 72 73 74 76 81 83 85 86 87 91 101 102 110 119 126 129 136 137 132 149 168 171 150 173 174 175 151 152 153 154 177 155 178 156 157 164 143 183 184 179 158 159 160 161 162 133 163 181 
27 28 31 58 63 65 68 70 71 75 76 77 86 94 100 101 102 105 106 190 
31 86 88 89 90 91 92 93 119 126 130 136 137 147 148 149 168 169 170 171 150 172 173 174 175 176 182 151 152 153 154 177 155 178 156 157 179 158 159 160 161 162 133 180 163 181 
25 29 30 31 78 81 83 86 87 89 91 97 104 113 115 119 126 130 132 136 137 148 149 168 169 171 150 172 173 174 175 176 151 152 153 154 177 155 178 156 157 179 159 160 161 162 141 164 145 146 191 180 163 181 
126 135 136 137 
126 134 138 136 137 139 140 
31 81 83 102 119 126 130 132 133 134 135 164 143 165 166 167 137 147 148 149 168 169 170 171 150 172 173 174 175 176 151 152 153 154 177 178 156 157 179 159 160 161 180 163 181 
31 81 83 119 126 130 132 133 134 135 136 164 147 148 149 168 170 171 150 172 173 174 175 176 151 152 153 154 177 155 178 156 157 179 159 160 161 162 163 181 
126 135 148 141 142 
135 193 140 
135 139 193 192 
125 126 133 138 148 142 
126 138 141 148 163 
126 130 136 149 175 152 153 177 156 157 158 161 162 164 
126 157 180 165 192 
32 124 126 133 154 146 
32 124 126 133 145 154 
126 132 136 137 148 149 168 169 170 171 150 172 173 174 175 176 
119 126 132 133 136 137 138 141 142 147 149 169 170 150 172 173 174 175 176 152 156 160 161 180 181 
113 119 126 130 132 133 136 137 143 147 148 164 168 169 170 171 150 172 173 174 175 176 152 153 156 157 158 160 161 180 181 
30 31 81 83 119 126 130 132 133 136 137 147 148 149 168 169 170 171 164 172 173 174 175 176 151 152 153 154 177 155 178 156 157 179 159 160 161 162 181 
126 130 132 133 136 137 150 153 154 155 159 160 162 
119 126 130 132 133 136 137 143 148 149 150 168 169 170 171 172 174 175 176 164 153 156 157 158 160 161 180 181 
31 81 83 119 126 130 132 133 136 137 143 149 150 151 152 168 171 173 175 164 154 155 156 157 179 158 159 160 161 162 181 
30 31 126 130 132 133 136 137 145 146 150 151 153 177 155 178 159 160 162 
30 31 126 130 132 133 137 150 151 153 154 177 178 159 160 162 
31 81 83 101 102 119 126 130 132 133 136 137 143 148 149 150 152 153 168 169 170 171 172 173 174 175 176 177 178 164 183 184 157 179 158 160 161 180 163 181 
31 65 81 83 97 101 104 119 126 130 132 133 136 137 143 144 149 150 152 153 156 168 171 173 174 175 164 165 179 158 160 161 181 
126 130 132 143 149 152 153 156 157 168 171 175 179 164 160 161 
30 31 126 130 132 133 136 137 150 151 153 154 155 177 178 160 162 
31 76 81 83 119 126 130 132 133 136 137 148 149 150 151 152 153 154 155 156 157 158 159 168 169 170 171 172 173 174 175 176 177 178 179 164 161 162 180 181 
31 81 83 119 126 130 132 133 136 137 143 148 149 150 152 153 156 157 158 160 168 169 170 172 173 174 175 176 164 180 181 
30 31 126 130 132 133 137 143 150 151 153 154 155 159 160 177 178 
31 126 130 132 133 136 137 142 156 174 177 178 
31 81 83 119 130 133 136 137 143 149 150 152 153 156 157 158 160 161 168 174 175 181 
136 144 157 172 180 192 
136 180 192 
136 171 
31 81 83 119 130 132 133 136 137 147 149 150 152 153 156 157 158 160 161 164 183 184 169 170 171 173 174 179 181 
119 132 133 136 147 148 149 150 152 156 160 161 168 170 172 173 176 180 181 
132 136 137 147 148 149 150 152 156 160 161 168 169 171 172 173 174 175 176 
31 113 130 132 133 136 137 147 149 150 152 153 156 157 158 160 167 168 170 173 174 179 180 
119 132 133 136 137 147 148 149 150 152 156 160 161 165 169 170 173 174 175 176 180 181 
130 132 133 136 137 147 148 149 150 153 156 157 160 161 168 169 170 171 172 174 175 176 179 
130 132 133 136 137 147 148 149 150 152 156 157 160 161 163 164 168 170 171 172 173 175 176 181 
76 130 132 133 136 137 143 147 148 149 150 152 153 156 157 158 160 161 164 170 172 173 174 176 
32 44 45 46 79 119 120 123 132 133 136 137 147 148 149 150 152 156 160 161 169 170 172 173 174 175 185 186 180 181 187 
30 31 130 132 133 136 137 143 150 154 155 156 159 160 162 163 178 
27 29 30 31 97 118 130 132 133 136 137 150 154 155 156 159 160 162 163 177 
31 83 130 132 133 136 137 150 153 156 157 158 160 168 171 173 183 184 
113 119 132 133 136 144 148 149 152 156 160 161 165 166 169 171 172 176 192 181 
31 81 83 119 130 132 133 136 137 148 149 150 152 153 156 157 160 161 164 168 169 172 174 176 180 
132 
31 83 130 156 168 179 184 
31 83 130 156 168 179 183 
32 36 37 44 45 46 50 51 52 54 79 120 121 123 124 176 187 186 196 
31 32 38 40 44 45 46 49 53 61 79 97 112 116 120 123 176 185 187 
32 44 45 46 64 72 73 74 79 89 90 92 94 95 97 108 109 120 123 176 185 186 188 
64 72 73 74 89 90 92 94 95 97 108 109 187 
31 47 
27 28 31 43 63 65 67 70 75 76 77 91 101 102 105 106 122 131 
133 
140 144 165 166 180 
139 140 
76 102 104 197 
128 
36 45 46 50 51 121 124 185 198 
194 
196 
